No Devotion - 10,000 Summers
Kaskade - A Little More
Night Terrors of 1927 - Always Take You Back
Osca - Blood
Father John Misty - Bored In The USA
Teyana Taylor - Business
Theophilus London - Can't Stop (feat. Kanye West)
Becky G - Can't Stop Dancin'
Ella Eyre - Comeback
Foo Fighters - Congregation
CHVRCHES - Dead Air
Calvin Harris - Dollar Signs
Bring Me The Horizon - Drown
Deerhoof - Exit Only
The Lone Bellow - Fake Roses
Maddie & Tae - Fly
Pr0files - Forgive
Young & Sick - Ghost Of A Chance - RAC Mix
French For Rabbits - Goat
Mat Kearney - Heartbeat
Mariachi El Bronx - High Tide
Saint Saviour - Intravenous
Rebecca Clements - Lovechild
The Decemberists - Make You Better
K. Michelle - Maybe I Should Call
The 1975 - Medicine
Oh Land - Nothing Is Over
Baauer - One Touch (feat. AlunaGeorge and Rae Sremmurd)
Various Artists - Pell - New Music Tuesday Intro
Calvin Harris - Pray to God
Wu-Tang Clan - Ruckus In B Minor
Dirty South - Run Run Run
SOAK - Shuvels
Pink Floyd - Side 3, Pt. 4: Allons-y (1)
White Fever - Skeleton Disease
Fifth Harmony - Sledgehammer
Pvris - St. Patrick
Cash Cash - Surrender - Acoustic
Ludvig Moon - Swim Dream
Nick Jonas - Teacher
Damien Rice - The Greatest Bastard
Deptford Goth - The Loop
Pell - The Never (feat. LV Baby)
Angels & Airwaves - The Wolfpack
Theophilus London - Tribe (feat. Jesse Boykins III)
Ryan Hemsworth - Walk Me Home (with Lontalius)